####################
#  * *2       *  **#
# # #   #*# # #*# ##
#  3 * * *** **    #
###*# # # # #1# # 1#
#    2 d   *     **#
# # #*# # #   # #*##
##  * x    1  * f *#
# # # # #*# # # # ##
#   2****    *    *#
# #   # # # # # # ##
#  ** * s *    2   #
#* # 3   ** # # *  #
#  # # **  # #  ** #
####################