#########################
#  * *   *   1  *  ** # #
# # #   #*# # #*# #* 5  #
#    * * **s ** #  # ** #
###*# # # # *#   # #  * #
#          *     **# *  #
# # #*# # #   # #*#  ** #
## 3 * x   ##     * f * #
# # # # #*# # # # # * # #
#    ****  *#   *   ** *#
# #   # # ** # # # # # *#
#  ** ** b   *  #    *  #
#* # 3  # # ** # # ***  #
#  # # **  # # * # ** # #
# ** #   ***    # # * # #
# # *   #  ** 4 #  * #**#
# 1 ** # # **   b  ** # #
#########################