#########################
#  * ***   4  *  **  1 *#
# # #  ** #*# # #*# #2* #
# # *  1 ***# ** b *  # #
###*# # # #**  #3# # 2  #
#   4 * s #  ** #  ** * #
# # #*# # # 1  # #* **f #
##  * * # ##  * * f **  #
# # #   # # **# # # # * #
#  #**** 2 x   # * ** * #
# #d  # # # # 3**# # # *#
#  * * 1 ***  # #  5 ** #
#* # 3  # ** # # *** #1 #
# ** # **  * # * # ** #*#
# s ** #   * # # ** ##* #
# * 1 *** # b **  **  # #
# **** #  2  # # 1 **   #
#########################