#########################
#p * ***   4  *  **  1 *#
# # #  ** #*# # #*# #2* #
# # *  1 ***# ** b *  # #
###*# # # #**  #3# # 2  #
#   4 * s #  ** #  ** * #
# # #*# # # 1  # #* **f #
##  * * # ##  * * f **  #
# # # 3 # # **# # # # * #
#  #**** 2 x 1 # * ** * #
# #d  # # # # 3**# # # *#
#  * * 1 ***  # #  5 ** #
#* # 3  # ** # # *** #1 #
# ** # **  * # * # ** #*#
# s ** # 4 * # # ** ##* #
# * 1 *** # b **  **  # #
# **** #  2  # # 1 **   #
#########################