####################
#p * ***   4  *  **#
# # #   #*# # #*# ##
# # *  1 ***# ** w #
###*# # # # #3# # 2#
#   4 * s   **   **#
# # #*# # # 1  # #*#
##  * *    * * f **#
# # # # #*# # # # ##
#  #**** 2 x  * * *#
# #d  # # # # # # ##
#  * * 1 ***    5  #
#* # 3  # ** # # * #
# ** # **  * #  ** #
####################