#########################
#  * *   *   1  *  ** # #
# # #   #*# # #*# #* 2  #
#    * * **s ** #  # ** #
###*# # # # *#   # #  * #
#      d   *     **# *  #
# # #*# # #   # #*#  ** #
## 3 * x   ##     * f * #
# # # # #*# # # # # * # #
#    ****  *#   *   ** *#
# #   # # ** # # # # # *#
#  ** ** b   *  #    *  #
#* # 3  # # ** # # ***  #
#  # # **  # # * # ** # #
# ** #   *** f  # # * # #
# # *   #  ** 2 #  * #**#
# 1 ** # # **   d  ** # #
#########################