####################
#    ** **    * 2  #
# # # #*# # ### # ##
#*   4  ** * *d *  #
# #*# # # #*# # # ##
#*   *s* 1  *** x *#
### # # # **# # # ##
#  4**   ** *  1 * #
# #*# # #*#*#*#*# ##
#   **3   *   ***  #
#*# # # #*# # # # ##
# *2 # * **    ** *#
# # #**# #  # #*# ##
# ***   f ** 1 *   #
####################