#########################
#     ** 3 **    *   ** #
# # # #*# #* ##* # # #  #
#*      ** #  * *  * ** #
# #*# # # #*#    # #  1 #
#*   * *    *** x *   * #
### # # # **# # # #* # *#
#   **  #   ** *    **  #
# #*# # #b *#*# *#* # # #
#   **3   * #    ***   2#
#*# # # #*# # #**  # #  #
# *  # * **    #  ** ** #
# # #**# #  # #*# # # * #
# ***  #     **   *  ** #
# 1 ** # # *  # * 4 **  #
# *** # ** # # *  # **  #
# # s  ** 1 ##   *** *f #
#########################