#########################
#     ** 3 **    * 2 ** #
# # # #*# #* ##* # # #  #
#*   4  ** #  * *d * ** #
# #*# # # #*#    # #  1 #
#*   *s* 1  *** x * 3 * #
### # # # **# # # #* #  #
#  4**  #   ** *  1 **  #
# #*# # #b *#*# *#* # # #
#   **3   * #    *** 2  #
#*# # # #*# # #**  # # s#
# *2 # * **    #  ** ** #
# # #**# #  # #*# # # * #
# ***  #   f ** 1 *  ** #
# 1 ** # # *  # * d **  #
# *** # ** # # *  # **  #
# # s  ** 2 ##   *** *  #
#########################