#########################
#     ** 3 **    * 2 ** #
# # # #*# #* ##* # # #  #
#*      ** #  * *d * ** #
# #*# # # #*#    # #  1 #
#*   *s*    *** x *   * #
### # # # **# # # #* #  #
#   **  #   ** *    **  #
# #*# # #b *#*# *#* # # #
#   **3   * #    *** 2  #
#*# # # #*# # #**  # # s#
# *  # * **    #  ** ** #
# # #**# #  # #*# # # * #
# ***  #   f ** 1 *  ** #
# 1 ** # # *  # * d **  #
# *** # ** # # *  # **  #
# # s  **   ##   *** *  #
#########################