#########################
#  * ***      *  **  1 *#
# # #  ** #*# # #*# # * #
# # *    ***# ** b *  # #
###*# # # #**  # # # 2  #
#     * s #  ** #  ** * #
# # #*# # # 1  # #* **f #
##  * * # ##  * * f **  #
# # #   # # **# # # # *1#
#  #**** 2 x   # * ** * #
# #d  # # # #  **# # # *#
#  * *   ***  # #  4 ** #
#* #    # ** # # *** #  #
# ** # **  * # * # ** #*#
# s ** #   * # # ** ##* #
# * 1 *** # b **  **  # #
# **** #     # # 1 **5  #
#########################