#########################
#  * *2  *   1  *  ** # #
# # #   #*# # #*# #* 2  #
#  3 * * **s ** #  # ** #
###*# # # # *#   # # 1* #
#    2 d   *     **# *  #
# # #*# # #   # #*#  ** #
## 3 * x   ##  1  * f * #
# # # # #*# # # # # * # #
#   2****  *#   *   ** *#
# #   # # ** # # # # # *#
#  ** ** b   *  #  2 *  #
#* # 3  # # ** # # ***  #
#  # # **  # # * # ** # #
# ** # 1 *** f  # # * # #
# # *   #  ** 2 #  * #**#
# 1 ** # # **   d  ** # #
#########################